20,0,3,0,3,3,13,0
100,0,3,0,3,3,13,1
135,0,3,0,3,2,6,0
140,0,3,0,3,5,13,1
145,0,3,0,3,2,6,0
200,0,3,0,3,5,13,1
170,7,3,0,30,1,4,0
240,0,3,0,3,5,13,0
420,0,3,0,3,5,13,1
390,7,3,0,30,1,4,0
320,0,3,0,3,5,13,1
355,0,3,0,3,2,6,0
360,0,3,0,3,5,13,1
440,0,3,0,3,3,3,0
470,0,3,0,3,3,3,0
500,0,3,0,15,3,15,0
580,0,-5,0,3,3,7,0
580,0,13,0,3,6,7,0
590,0,1,0,5,9,13,0