20,0,3,0,3,5,9,0
65,0,3,0,3,2,6,1
75,0,3,0,3,2,6,0
100,0,3,0,3,5,9,1
135,0,3,0,3,2,6,0
140,0,3,0,3,5,9,1
145,0,3,0,3,2,6,0
200,0,3,0,3,5,9,1
170,7,3,0,30,1,4,0
