20,0,3,0,3,5,13,0
65,0,3,0,3,2,6,1
75,0,3,0,3,2,6,0
100,0,3,0,3,5,13,1
135,0,3,0,3,2,6,0
140,0,3,0,3,5,13,1
145,0,3,0,3,2,6,0
200,0,3,0,3,5,13,1
170,7,3,0,30,1,4,0
240,0,3,0,3,5,13,0
285,0,3,0,3,2,6,1
295,0,3,0,3,2,6,0
365,0,3,0,3,2,6,0
420,0,3,0,3,5,13,1
390,7,3,0,30,1,4,0
320,0,3,0,3,5,13,1
355,0,3,0,3,2,6,0
360,0,3,0,3,5,13,1