5,5,0,0,1,1,1
20,5,0,0,1,1,1
65,5,0,0,1,1,1
70,5,0,0,1,1,1
75,5,0,0,1,1,1
100,5,0,0,1,1,1
135,5,0,0,1,1,1
140,5,0,0,1,1,1
145,5,0,0,1,1,1
200,5,0,0,1,1,1
170,10,0,0,1,1,1
224,5,5,0,1,1,1
239,9,5,0,1,1,1
282,5,5,0,1,1,1
320,9,5,0,1,1,1
355,5,5,0,1,1,1
400,5,5,0,1,1,1
450,5,5,0,1,1,1
520,5,5,0,1,1,1
600,5,5,0,1,1,1
580,4,-5,0,1,1,1
580,9,15,0,1,1,1
590,12,2,0,1,1,1